Accommodate - размещать
Allowable - допустимый
Base - основание
Beam - балка
Bearing - несущий
Braced - укрепленный
Ceilings - потолки
Combined - комбинированный
Concrete - бетон
Consideration - рассмотрение
Constructed - построенный
Construction - строительство
Coping - перекрытие
Curved - изогнутый
Decking - настил
Defined - определенный
Designed - спроектированный
Desired - желаемый
Dimension - размер
Divider - разделитель
Domes - купола
Drainage - дренаж
Durability - долговечность
Earthquake - землетрясение
Enclose - окружать
Erection - возведение
Expansion - расширение
Exterior - внешний
Failure - отказ
Fire-resistant - огнестойкий
Flat - плоский
Flooring - напольное покрытие
Floors - этажи
Foundation - фундамент
Framework - каркас
Independent - независимый
Insulation - изоляция
Integral - целостный
Interior - внутренний
Joints - швы
Lateral - боковой
Levelling - выравнивание
Lintel - перемычка
Load transfer - передача нагрузки
Load-bearing - несущий
Location - расположение
Masonry - каменная кладка
Member - элемент
Mortar - раствор
Openings - проемы
Partition - перегородка
Pier - столб
Pitched - скатная (крыша)
Plaster - штукатурка
Plates - пластины
Plinth - цоколь
Pressure - давление
Projected - выступающий
Provided - предусмотренный
Purpose - цель
Reinforced - усиленный
Reinforcement - армирование
Requirement - требование
Resists - сопротивляется
Roof - крыша
Safety - безопасность
Satisfactory - удовлетворительный
Security - безопасность
Seismic - сейсмический
Shear - сдвиг
Shell - оболочка
Sills - подоконники
Slab - плита
Soffit - софит
Solid - твердый
Span - пролет
Specified - указанный
Stability - стабильность
Staircase - лестница
Stiffness - жесткость
Strength - прочность
Structural - конструктивный
Structural performance - конструкционная производительн
Sub-floor - подложка
Supports - опоры
Surface - поверхность
Surrounding - окружающий
Terracing - террасирование
Thermal - тепловой
Thickness - толщина
Throated - желобчатый
Tiles - плитки
Transfer - передача
Truss - ферма
Underlying - подлежащий
Upper - верхний
Uppermost - самый верхний
Vertical - вертикальный
Weather shades - защитные козырьки
Weight - вес
Width - ширина
Wind - ветер
Without - без
Withstand - выдерживать
